có thể - có thễ
tổ chức - tỗ chứt
sử dụng - sữ dụng, sử giụng
thời gian - thời dang
phát triển - phát triễn
xây dựng - sây dựng, sây giựng
gia đình - da đình
lào cai - nào cai
như nào - dư lào, như lào
lấp liếm - nấp niếm
sản xuất - xản xuất, sản suất
chia sẻ - chia sẽ
hỗ trợ - hổ chợ, hỗ chợ
xử lý - sử lí
quan trọng - quan chọng
cơ sở - cơ xở
du lịch - du nịch, giu nịch
chất lượng - chất nượng, chắc nượng
lãnh đạo - nãnh đạo
dịch vụ - dịch dụ
nghiên cứu - nghiêng cú
lao động - nao động
nước ngoài - lước ngoài
lĩnh vực - nĩnh vục
pháp luật - pháp nuật
trở lại - chở nại
diễn viên - diễn diên
lựa chọn - nựa chọn
sinh viên - sinh diên, sanh diên
nhân viên - nhân diên, nhưn diên
lịch sử - nịch xữ, lịch xử, nịch sử
liên tục - niên tục
thành lập - thành nập
ca sĩ - ca sỉ
nỗ lực - lỗ nực, nỗ nực, lỗ lực
tên lửa - tên nữa
đất nước - đấc lướt, đất lước
bệnh nhân - bịnh nhân
trả lời - chả nời, trả nời, chả lời
số lượng - số nượng, xố lượng
lý do - ní do
nhà nước - nhà lướt, nhà lước
nhất là - nhấc nà, nhất nà
tai nạn - tai lạn, tai lạng
chính trị - chính chị
tương lai - tương nai
tỷ lệ - tỉ nệ
xuất khẩu - suất khẩu
nhậm chức - nhận chức
vô hình trung - vô hình chung
chiến lược - chiếng nược, chiến nượt
nhập khẩu - dập khẩu
duy trì - duy chì
truyền thông - chuyền thông
dư luận - giư nuận, dư nuận
năng lực - lăng lực, năng nực, lăng nực
việc làm - việc nàm
lợi ích - nợi ích
rõ ràng - dõ dàng
tiết lộ - tiết nộ
năng lượng - năng nượng, lăng lượng, lăng nượng
hàng loạt - hàn noạt, hoàng loạt
thời trang - thời chang
thuận lợi - thuận nợi
lợi nhuận - nợi nhuận
lo lắng - no nắng
nông dân - lông giân, lông dân
dữ liệu - giữ niệu
kết luận - kết nuận
áp lực - áp nực
lãi suất - nãi xuất, nãi suất, lãi xuất
tâm lý - tâm ní
vệ sinh - vệ xinh
trật tự - chật tự
liên tiếp - niên tiếp
liên tục - niên tục
có lẽ - có nẽ
cấp cứu - cấp cú
lái xe - nái xe, lái se, nái se
lễ hội - nễ hội
hợp lý - hợp ní
tài năng - tài lăng
trái phép - chái phép
năm ngoái - lăm ngói, năm ngói
trụ sở - chụ xở, chụ sở
lên tiếng - nên tiếng
thảo luận - thảo nuận
suy nghĩ - si nghỉ, xuy nghĩ, xi nghĩ
tài liệu - tài niệu
tính năng - tín lăng, tính lăng
lo ngại - no ngại
bình luận - bìn nuận, bình nuận
kỹ năng - kĩ lăng
lãnh thổ - nãnh thỗ, nãnh thổ
khổng lồ - khổng nồ
kỷ lục - kỉ nục
độc lập - độc nập, độc nặp
công suất - công xuất
màu sắc - màu xắt
liên kết - niên kết
phần lớn - phần nớn
trực tuyến - chực tuyến
hình sự - hìn xự
xét xử - sét sử, xét sử
kỷ luật - kĩ nuật
nguyên liệu - nguyên niệu, nguyên nịu
lúc nào - lúc lào, núc nào, núc lào
huấn luyện - huấn nuyện
chỉ trích - chỉ chích, trỉ trích
sau này - sau lày, sau lầy
pháp lý - pháp ní
liên lạc - niên nạc
lưu ý - niu í, nưu í, niêu í
luật sư - nuật xư, nuật sư
nền tảng - lền tản, lềnh tảng
giao lưu - dao nưu, giao niu
triển lãm - chiển nãm, triển nãm, chiễn lãm, triễn lãm
đi lại - đi nại
trọng tài - chọng tài
trừng phạt - chừng phạt
hiệu lực - hịu nực, hịu lực, hiệu nực
lưu thông - liu thông, niu thông, nưu thông
vật liệu - vật niệu, vật nịu
lâu dài - nâu dài
tiêu cực - tiu cực
lợi thế - nợi thế
thiết lập - thiếc nập, thiết nập
quyết liệt - quyết niệt
đấu tranh - đấu chanh
liên hệ - niên hệ
nhân lực - nhân nực
tập luyện - tập nuyện
nước mắt - lước mắt
khối lượng - khối nượng
làm sao - nàm sao, nàm thao, nàm xao
xin lỗi - sin lỗi, sin nỗi, xin nỗi
quyền lợi - quyền nợi
năm học - lăm học
lần lượt - nần nược, nần nượt
ngược lại - ngược nại
số liệu - xố niệu, số niệu
động lực - động nực
nhiên liệu - nhiên niệu
loại bỏ - noại bỏ
tài trợ - tài chợ
nặng nề - lặng lề, lặn lề
chăn nuôi - chăn luôi, trăn luôi, trăn nuôi
sang trọng - xang chọng, sang chọng
đặc trưng -đặc chưng
sai lầm - xai lầm, sai nầm, xai nầm
quyền lực - quyền nực
sâu sắc - xâu xắc
phát sinh - phát xinh
bạo lực - bạo nực
sạt lở - sạt nở, sạc lở, xạt nở, xạc lở
nguồn lực - ngùn lực, nguồn nực, ngùn nực
trang trí - chang chí
ngày nay - ngày lay, ngày lây
làm ăn - nàm ăn
xán lạng - sáng lạng
sáng tác - xáng tác
nhan sắc - nhang xắc
niêm yết - liêm yết
so sánh - xo xánh
tuần tra - tuần cha
lắp đặt - nắp đặt
bán lẻ - bán lẻ
trò chuyện - chò truyện, chò chuyện
lợi dụng - nợi dụng
trực thuộc - chực thuộc
sản lượng - xản nượng, sản nượng
khẩn trương - khẩn chương
thuốc lá - thuốc ná
lừa đảo - nừa đảo
loại hình - noại hìn, loại hìn
lập tức - nập tức
trạng thái - chạng thái
ly hôn - ny hôn
đại lý - đại ní
mạng lưới - mạng nưới
tỉ lệ - tỉ nệ
năng suất - lăng suất, năng xuất, lăn suất
lộ trình - nộ chình, lộ chình
trọng lượng - chọng nượng, trọng nượng, chọng lượng
triệu chứng - chiệu chứng, triệu trứng
đối lập - đối nập, đối nặp
lãng mạn - nãng mạn
người lớn - người nớn
vết thương - dết thương
lãng phí - nãng phí
liên minh - niên minh
quốc lộ - quốc nộ
lý tưởng - ní tưởng
trẻ trung - chẻ chung
cấu trúc - cáu chúc, cấu chúc, cáu trúc
khắp nơi - khấp lơi
dân sự - dưn xự, dưn sự, dân xự
to lớn - to nớn
đô la - đô na
nước thải - lước thải, nước thãi, lước thãi
trinh sát - chinh xát, trinh xát, chinh sát
lành mạnh - nành mạnh
lưu trữ - niu chữ, nưu chữ, niu trữ, nưu trữ
trọng tâm - chọng tâm
trang điểm - chang điểm
vô tình - vô tìn
làm đẹp - nàm đẹp
rối loạn - dối noạn, rối noạn
nông sản - lông sản, lông xản, nông xản
thập niên - thập liên, thặp liên
linh hoạt - ninh hoạt
nếu như - lếu như
xôn xao - sôn sao
luật pháp - nuật pháp
lạm phát - nạm phát
nội thất - lội thất
năng động - lăng động
chênh lệch - chênh nệch
tức là - tức nà
nắng nóng - lắng lóng
công lập - công nập
làm nên - nàm nên, làm lên
rèn luyện - dèn nuyện, rèn nuyện
trang trại - chang chại
chẩn đoán - chuẩn đoán
thắng lợi - thắng nợi
lạm dụng - nạm dụng
chất liệu - chất niệu
lý giải - ní dải
lắng nghe - nắng nghe
lớp học - nớp học
vòng loại - vòng noại
hàm lượng - hàm nượng
thực trạng - thực chạng
kim loại - kiêm noại, kim noại
đồng tình - đồng tìn
sát hại - xát hại
hành lang - hành nang
nước sạch - lước sạch, lước xạch, nước xạch
sinh học - xinh học
tiền lương - tiền nương
dự trữ - dự chữ
trao tặng - chao tặng
khéo léo - khéo néo
nổi dậy - lổi dậy, lỗi dậy
thận trọng - thận chọng
vượt trội - vượt chội
xuất xứ - suất sứ
sáng lập - sáng nập, xáng nập, xáng lập
ngoại lệ - ngoại nệ
bản lĩnh - bản nĩnh
im lặng - im nặng
đặc sản - đặc xảng
sáp nhập - sát nhập, xát nhập, xáp nhập
kỳ lạ - kì nạ
tranh luận - chanh nuận, tranh nuận
lạc quan - nạc quan
tranh cử - chanh cử
đồng loạt - dồng noạt
lân cận - nân cận
vóc dáng - dóc dáng
lương thực - nương thực
nắm bắt - lắn bắt
mã lực - mả nực, mã nực
tị nạn - tị lạn
nước biển - lước biển
đất liền - đất niền
gian lận - dan nận, gian nận
liệt sĩ - niệt sĩ
phân loại - phân noại
thường niên - thương niên
triệu tập - chiệu tập, chịu tập
qua lại - qua nại
nghĩa là - nghĩa nà
buôn lậu - buông lậu, buôn nậu
lưu giữ - nưu giữ, niu giữ, lưu dữ
nuôi dưỡng - luôi dưỡng
trợ lý - chợ lý, trợ ní, chợ ní
nảy sinh - lảy sinh, lẩy sinh, lẩy xinh, nảy xinh
lên đường - nên đường
hoành tráng - hoành cháng
khai trương - khai chương
chăm lo - chăm no, trăm no
lên án - nên ác
triển vọng - triên dọng, chiển dọng, chiển vọng
đấu trường - đấu chường
rắc rối - dắc dối, dất dối
sạch sẽ - xạch xẽ
lên ngôi - nên ngôi
thể loại - thể noại
rò rỉ - dò dỉ
lan toả - nan tỏa
dung lượng - dung nượng
sơ sinh - xơ xinh
trầm trọng - chầm chọng
mưa lũ - mưa nũ
thể lực - thể nực
tư liệu - tư niệu
lắp ráp - nắp dáp, lắp dáp, nắp ráp
ra lệnh - da nệnh, da lệnh, ra nệnh
sai sót - xai xót
hiệu trưởng - hịu chưởng, hiệu chưởng
thủ lĩnh - thủ nĩnh
tâm trạng - tâm chạng